#domain
hospital
#levelname
MAExample6
#colors
red: 0, A
#initial
++++++++++++++
+         0  +
+            +
+A          A+
+            +
+            +
++++++++++++++
#goal
++++++++++++++
+            +
+            +
+            +
+            +
+A          A+
++++++++++++++
#end