#domain
hospital
#levelname
MAExample
#colors
red: 0, A
green: 1, B
cyan: 2, C
#initial
++++++++++++
+  2    0+A+
+ ++++++++ +
+         C+
+B+B++++++ +
+ +1       +
++++++++++++
#goal
++++++++++++
+        +A+
+ ++++++++ +
+          +
+ + ++++++ +
+B+       C+
++++++++++++
#end