#domain
hospital
#levelname
MAExample
#colors
red: 0, A
green: 1, B
#initial
++++++++++++
+       0+A+
+ ++++++++ +
+          +
+B+ ++++++ +
+ +1B      +
++++++++++++
#goal
++++++++++++
+        +A+
+ ++++++++ +
+          +
+ + ++++++ +
+B+        +
++++++++++++
#end