#domain
hospital
#levelname
MAVeryEasyPeasy
#colors
red: 0, A
blue: 1, B
green: 2, C
orange: 3, D
cyan: 4, E
#initial
++++++++++++++
+0     A     +
+1     B     +
+2     C     +
+3     D     +
+4     E     +
++++++++++++++
#goal
++++++++++++++
+           A+
+           B+
+           C+
+           D+
+           E+
++++++++++++++
#end
