#domain
hospital
#levelname
MAVeryEasyPeasy
#colors
red: 0, A
blue: 1, B
green: 2, C
orange: 3, D
cyan: 4, E
#initial
++++++++++++++
+A     0     +
+B     1     +
+C     2     +
+D     3     +
+E     4     +
++++++++++++++
#goal
++++++++++++++
+           A+
+           B+
+           C+
+           D+
+           E+
++++++++++++++
#end
