#domain
hospital
#levelname
SAbonguu
#colors
blue: 0, A, B, C, D, E
#initial
+++++++++++++++++
+0 C            +
+    D  +++++++++
+  B            +
+     E +++++++++
+   A           +
+++++++++++++++++
#goal
+++++++++++++++++
+               +
+       +++++++++
+       E DC A B+
+       +++++++++
+               +
+++++++++++++++++
#end
