#domain
hospital
#levelname
SAbongu2
#colors
blue: 0, A, B, C, D, E
#initial
+++++++++++++++++
+0   C          +
+       +++++++++
+  A          E +
+     B +++++++++
+ D             +
+++++++++++++++++
#goal
+++++++++++++++++
+               +
+       +++++++++
+        A BC DE+
+       +++++++++
+               +
+++++++++++++++++
#end
