#domain
hospital
#levelname
SAbongu3
#colors
blue: 0, A, B, C, D
#initial
+++++++++++++++++
+0   C          +
+       +++++++++
+  A            +
+     B +++++++++
+ D             +
+++++++++++++++++
#goal
+++++++++++++++++
+               +
+       +++++++++
+        A BC D +
+       +++++++++
+               +
+++++++++++++++++
#end
